3 10 215 998 6846 1795 4217 5119 1042 980 4578 6732 
1 7 642 6855 2801 4535 253 3657 1795 
1 17 2514 507 2810 3201 5226 6831 182 837 1519 4550 4657 1418 869 12 3972 6861 215 
1 19 2514 6779 2249 3462 2537 1612 4499 445 4338 1044 3023 3387 6767 1601 4485 935 2475 6727 6732 
1 14 6732 3776 4694 904 2650 4526 742 3173 1301 2728 3475 1545 1408 2185 
1 9 642 567 6832 484 6796 3818 4810 4578 6732 
