3 10 215 998 6846 1795 4217 5119 1042 980 4578 6732 
1 7 642 6855 2801 4535 253 3657 1795 
1 19 2514 6779 2249 3462 2537 1612 4499 445 4338 1044 3023 3387 6767 1601 4485 935 2475 6727 6732 
1 15 6732 3776 4694 904 2650 4526 742 3173 1301 2728 3475 1545 1408 2185 4024 
1 9 642 567 6832 484 6796 3818 4810 4578 6732 
1 10 4024 6407 4663 5025 6412 2594 6402 6426 6422 1431 
1 12 68 1027 4767 3299 2460 4723 2276 6276 1897 4778 500 6349 
1 20 4380 6240 6260 6263 4530 2717 353 5178 1889 6257 3265 4043 1094 1131 1842 6285 4848 6299 3827 5000 
1 27 3827 1874 6324 6337 4861 4222 3581 6370 3518 2854 739 2118 6486 3478 3618 4430 1766 4339 4333 6632 6645 4135 5079 492 5160 6671 2894 
1 9 6610 6598 6584 6578 139 6579 1971 1968 4333 
1 16 2854 3571 6411 5191 2015 6406 6403 4658 6442 4503 6441 4922 1640 3081 1424 6349 
1 14 4745 3547 4747 434 4912 2382 6802 4984 3913 4316 4843 3364 2539 6663 
1 13 4747 6852 2028 200 6847 4265 1218 6840 1240 1817 2425 4538 642 
1 14 858 161 6507 3126 4155 6565 1541 6616 4944 5031 1233 6683 1479 1032 
1 7 161 2936 5051 4081 4266 6527 4683 
1 18 858 3248 6381 4371 6327 62 2191 1245 4101 3405 6196 6151 4604 2206 2770 2316 4629 5972 
1 5 5912 2510 599 4727 5972 
1 6 4024 1987 6322 2156 2543 579 
1 6 2543 6229 6194 4480 438 2359 
1 12 6226 4042 1100 4482 6147 3150 6123 6105 3033 5213 821 1221 
1 9 6226 4401 6251 2751 6261 3889 788 6264 5000 
1 2 108 2751 
1 6 3257 6164 1155 2630 5195 6264 
1 6 6133 6171 3289 3096 6228 1889 
1 13 6133 3484 6145 818 6137 6131 3507 2657 6138 614 3738 3089 6164 
1 5 6370 6347 3920 6298 4043 
1 10 68 6247 6275 2890 4270 6308 6330 6353 4109 1431 
1 2 427 6308 
1 13 427 4023 4022 2478 1052 6265 2548 5177 6243 6252 2362 6262 2543 
1 8 68 6204 4360 713 537 3204 3086 1457 
1 16 68 1821 4793 2505 1306 5215 2944 6121 1340 6089 3483 6087 811 4418 3035 6024 
1 24 1431 4949 583 4116 530 6471 746 2659 6461 2589 6496 4389 2369 1756 220 6472 3038 2970 6462 1246 6474 6469 4544 4503 
1 8 4005 3690 3379 6560 4346 519 6495 530 
1 14 6848 4090 4513 3457 3286 4671 1986 4659 2234 1406 2946 6933 2986 2877 
1 4 4671 3749 6898 3447 
1 8 3447 6905 2391 6914 5110 4702 1426 2877 
1 9 3447 5077 439 5144 809 3487 2671 4766 1800 
1 10 6802 6817 3283 3860 3498 6797 6790 1477 6762 4733 
1 6 1285 1603 555 6238 6272 1897 
1 6 555 6233 1363 6273 3977 4380 
1 5 1285 3764 4123 6128 186 
1 6 3017 2816 4619 6182 4726 3299 
1 9 4619 4440 3543 252 2485 6197 1891 6188 1285 
1 5 3195 1203 867 4839 4767 
1 6 3195 169 1499 6409 2730 6461 
1 6 3195 231 4886 277 6313 1897 
1 5 1424 2611 2723 874 4380 
1 6 4165 2150 6354 6335 3007 6349 
1 4 6472 912 6410 4165 
1 4 4165 6390 274 231 
1 11 6663 3649 1735 6618 6630 5088 1419 3958 3999 6557 6560 
1 12 6663 6653 2779 5146 3385 2458 3174 2145 6588 5162 3165 3173 
1 13 1800 4556 6828 4758 2381 3243 6818 330 6824 2706 4467 859 434 
1 4 3933 1124 3060 3227 
1 5 6308 3016 1992 393 746 
1 5 2717 6301 2080 6385 6403 
1 3 1874 3795 6371 
1 9 215 6861 3972 12 869 5171 524 4550 445 
1 5 6601 4775 3413 2838 2650 
1 2 6601 4696 
1 4 6601 2162 257 3173 
1 6 6285 4707 3296 4561 3603 6138 
1 9 6171 3289 6183 3861 564 1004 460 1521 6240 
1 4 3017 3858 6077 541 
1 2 4878 2988 
1 10 4878 6684 6705 458 852 4512 6734 2282 6737 1032 
1 5 458 2920 4378 1806 3841 
1 3 6556 3723 3841 
1 8 3841 1604 1482 1159 6622 6648 4967 4944 
1 4 2988 2926 1568 6757 
1 12 1568 4423 2314 6741 3606 67 6736 899 6748 710 2698 2514 
1 5 1308 4420 1416 4484 899 
1 2 1308 6623 
1 16 6623 3868 3580 3561 3662 3508 3458 337 1343 2317 349 4752 1060 2339 6716 4485 
1 3 1343 4529 3349 
1 2 1343 1181 
